1111111111111111111111111
1000001000000000000000001
1000001000000000000000001
1000001000000000000000001
1000001000000000000000001
1000001000000N00000000001
1000001000000000000000001
1000000000000000000000001
1000000000000000110000001
1000000000000000110000001
1000000000000000000000001
1000000000000000000000001
1000000000000000000000001
1111111111111111111111111